+--+--+--+--+--+--+--+--+--+--+--+--+--+--+--+--+
|p    |                       |           |     |
+  +  +--+--+--+--+  +  +--+  +--+  +--+  +  +  +
|  |     |        |  |     |        |     |  |  |
+  +--+  +  +--+  +--+--+  +--+--+--+  +--+  +  +
|  |  |     |  |     |     |           |     |  |
+  +  +--+--+  +--+  +  +--+--+--+--+--+  +--+  +
|  |                    |           |        |  |
+  +--+--+  +--+--+--+  +  +--+--+  +  +--+--+  +
|        |  |     |     |  |  |     |     |     |
+  +--+  +--+  +  +  +--+  +  +  +--+  +--+  +  +
|  |     |     |  |     |     |  |     |     |  |
+--+  +--+  +--+  +--+--+--+  +  +  +--+  +--+  +
|     |     |  |           |  |     |  |  |  |  |
+  +--+  +--+  +--+--+--+  +  +--+--+  +  +  +  +
|                       |              |  |    g|
+--+--+--+--+--+--+--+--+--+--+--+--+--+--+--+--+
