+--+--+--+--+
|p          |
+--+--+--+  +
|        |  |
+  +--+  +  +
|     |  |  |
+--+  +--+  +
|          g|
+--+--+--+--+
