+--+--+--+--+
|           |
+--+--+--+  +
|        |  |
+  +--+  +  +
|     |  |  |
+--+  +--+  +
|          g|
+--+--+--+--+
