+--+--+--+--+
|           |
+--+--+--+  +
|        |  |
+  +--+  +  +
|     | g|  |
+--+  +--+  +
|           |
+--+--+--+--+
